20 15
10 2

11111111111111111111
10011111101111111111
10111111101111111111
10110000000000000011
10110111101111111011
10110111101000111011
10110111101310111011
10110111101110111011
10110111100000111011
10110111111111111011
10110000111110000011
10111110111110111111
10000000111110111111
11111111100000000051
11111111111111111111


9

12 7 5 0 0 0

10 3 1 5 0 0 
18 4 2 0 10 0
3 2 4 0 0 0
10 14 4 0 0 0
10 9 3 0 0 14
14 14 1 10 0 0
17 14 2 0 30 0
5 4 3 0 0 10

