15 15
2 2

111111111111111
100000011111111
100111011100011
101111011101011
101110000001011
100001011011011
111101011000011
111101011111111
111101011111111
130001000000111
111101111110111
111101111110111
111101111110111
115000000000111
111111111111111


12

2 10 5 0 0 0

5 10 1 10 0 0
4 14 3 0 20 0 
6 5 4 0 0 0
7 2 1 9 0 0
13 3 3 0 0 10
12 14 1 10 0 0
2 3 2 0 5 0 
3 6 2 0 12 0

7 10 1 15 0 0
10 10 3 0 0 13
7 14 1 30 0 0
